30 30 30 30 30 30 30 30 30 30 30 30 30 30 30 30 30 30 30 30 30 30 30 30 30 30 30 30 30 30 30 30 30 30 30 30 30 30 30 30 30 30 30 30 30 30 30 30 30 30 30 30 30 30 30 30 30 30 30 30 30 30 30 30 30 30 30 30 30 30 30 30 30 30 30 30 30 30 30 30 30 30 30 30 30 30 30 30 30 30 30 30 30 30 30 30 30 30 30 30
30 30 30 30 30 30 30 30 30 30 30 30 30 30 30 30 30 30 30 30 30 30 30 30 30 30 30 30 30 30 30 30 30 30 30 30 30 30 30 30 30 30 30 30 30 30 30 30 30 30 30 30 30 30 30 30 30 30 30 30 30 30 30 30 30 30 30 30 30 30 30 30 30 30 30 30 30 30 30 30 30 30 30 30 30 30 30 30 30 30 30 30 30 30 30 30 30 30 30 30
30 30 30 30 30 30 30 30 30 30 30 30 30 30 30 30 30 30 30 30 30 30 30 30 30 30 30 30 30 30 30 30 30 30 30 30 30 30 30 30 30 30 30 30 30 30 30 30 30 30 30 30 30 30 30 30 30 30 30 30 30 30 30 30 30 30 30 30 30 30 30 30 30 30 30 30 30 30 30 30 30 30 30 30 30 30 30 30 30 30 30 30 30 30 30 30 30 30 30 30
30 30 30 30 30 30 30 30 30 30 30 30 30 30 30 30 30 30 30 30 30 30 30 30 30 30 30 30 30 30 30 30 30 30 30 30 30 30 30 30 30 30 30 30 30 30 30 30 30 30 30 30 30 30 30 30 30 30 30 30 30 30 30 30 30 30 30 30 30 30 30 30 30 30 30 30 30 30 30 30 30 30 30 30 30 30 30 30 30 30 30 30 30 30 30 30 30 30 30 30
30 30 30 30 30 30 30 30 30 30 30 30 30 30 30 30 30 30 30 30 30 30 30 30 30 30 30 30 30 30 30 30 30 30 30 30 30 30 30 30 30 30 30 30 30 30 30 30 30 30 30 30 30 30 30 30 30 30 30 30 30 30 30 30 30 30 30 30 30 30 30 30 30 30 30 30 30 30 30 30 30 30 30 30 30 30 30 30 30 30 30 30 30 30 30 30 30 30 30 30
30 30 30 30 30 30 30 30 30 30 30 30 30 30 30 30 30 30 30 30 30 30 30 30 30 30 30 30 30 30 30 30 30 30 30 30 30 30 30 30 30 30 30 30 30 30 30 30 30 30 30 30 30 30 30 30 30 30 30 30 30 30 30 30 30 30 30 30 30 30 30 30 30 30 30 30 30 30 30 30 30 30 30 30 30 30 30 30 30 30 30 30 30 30 30 30 30 30 30 30
30 30 30 30 30 30 30 30 30 30 30 30 30 30 30 30 30 30 30 30 30 30 30 30 30 30 30 30 30 30 30 30 30 30 30 30 30 30 30 30 30 30 30 30 30 30 30 30 30 30 30 30 30 30 30 30 30 30 30 30 30 30 30 30 30 30 30 30 30 30 30 30 30 30 30 30 30 30 30 30 30 30 30 30 30 30 30 30 30 30 30 30 30 30 30 30 30 30 30 30
30 30 30 30 30 30 30 30 30 30 30 30 30 30 30 30 30 30 30 30 30 30 30 30 30 30 30 30 30 30 30 30 30 30 30 30 30 30 30 30 30 30 30 30 30 30 30 30 30 30 30 30 30 30 30 30 30 30 30 30 30 30 30 30 30 30 30 30 30 30 30 30 30 30 30 30 30 30 30 30 30 30 30 30 30 30 30 30 30 30 30 30 30 30 30 30 30 30 30 30
30 30 30 30 30 30 30 30 30 30 30 30 30 30 30 30 30 30 30 30 30 30 30 30 30 30 30 30 30 30 30 30 30 30 30 30 30 30 30 30 30 30 30 30 30 30 30 30 30 30 30 30 30 30 30 30 30 30 30 30 30 30 30 30 30 30 30 30 30 30 30 30 30 30 30 30 30 30 30 30 30 30 30 30 30 30 30 30 30 30 30 30 30 30 30 30 30 30 30 30
30 30 30 30 30 30 30 30 30 30 30 30 30 30 30 30 30 30 30 30 30 30 30 30 30 30 30 30 30 30 30 30 30 30 30 30 30 30 30 30 30 30 30 30 30 30 30 30 30 30 30 30 30 30 30 30 30 30 30 30 30 30 30 30 30 30 30 30 30 30 30 30 30 30 30 30 30 30 30 30 30 30 30 30 30 30 30 30 30 30 30 30 30 30 30 30 30 30 30 30
30 30 30 30 30 30 30 30 30 30 30 30 30 30 30 30 30 30 30 30 30 30 30 30 30 30 30 30 30 30 30 30 30 30 30 30 30 30 30 30 30 30 30 30 30 30 30 30 30 30 30 30 30 30 30 30 30 30 30 30 30 30 30 30 30 30 30 30 30 30 30 30 30 30 30 30 30 30 30 30 30 30 30 30 30 30 30 30 30 30 30 30 30 30 30 30 30 30 30 30
30 30 30 30 30 30 30 30 30 30 30 30 30 30 30 30 30 30 30 30 30 30 30 30 30 30 30 30 30 30 30 30 30 30 30 30 30 30 30 30 30 30 30 30 30 30 30 30 30 30 30 30 30 30 30 30 30 30 30 30 30 30 30 30 30 30 30 30 30 30 30 30 30 30 30 30 30 30 30 30 30 30 30 30 30 30 30 30 30 30 30 30 30 30 30 30 30 30 30 30
30 30 30 30 30 30 30 30 30 30 30 30 30 30 30 30 30 30 30 30 30 30 30 30 30 30 30 30 30 30 30 30 30 30 30 30 30 30 30 30 30 30 30 30 30 30 30 30 30 30 30 30 30 30 30 30 30 30 30 30 30 30 30 30 30 30 30 30 30 30 30 30 30 30 30 30 30 30 30 30 30 30 30 30 30 30 30 30 30 30 30 30 30 30 30 30 30 30 30 30
30 30 30 30 30 30 30 30 30 30 30 30 30 30 30 30 30 30 30 30 30 30 30 30 30 30 30 30 30 30 30 30 30 30 30 30 30 30 30 30 30 30 30 30 30 30 30 30 30 30 30 30 30 30 30 30 30 30 30 30 30 30 30 30 30 30 30 30 30 30 30 30 30 30 30 30 30 30 30 30 30 30 30 30 30 30 30 30 30 30 30 30 30 30 30 30 30 30 30 30
30 30 30 30 30 30 30 30 30 30 30 30 30 30 30 30 30 30 30 30 30 30 30 30 30 30 30 30 30 30 30 30 30 35 33 33 33 33 33 33 33 33 33 33 33 33 33 33 33 33 33 36 30 30 30 30 30 30 30 30 30 30 30 30 30 30 30 30 30 30 30 30 30 30 30 30 30 30 30 30 30 30 30 30 30 30 30 30 30 30 30 30 30 30 30 30 30 30 30 30
30 30 30 30 30 30 30 30 30 30 30 30 30 30 30 30 30 30 30 30 30 30 30 30 30 30 30 30 30 30 35 33 33 34 25 25 25 25 25 25 25 25 25 25 25 25 25 25 25 25 25 32 33 33 36 30 30 30 30 30 30 30 30 30 30 30 30 30 30 30 30 30 30 30 30 30 30 30 30 30 30 30 30 30 30 30 30 30 30 30 30 30 30 30 30 30 30 30 30 30
30 30 30 30 30 30 30 30 30 30 30 30 30 30 30 30 30 30 30 30 30 30 30 30 30 30 30 30 35 33 34 25 25 25 25 25 25 25 25 25 25 25 25 25 25 25 25 25 25 25 25 25 25 25 32 33 33 36 30 30 30 30 30 30 30 30 30 30 30 30 30 30 30 30 30 30 30 30 30 30 30 30 30 30 30 30 30 30 30 30 30 30 30 30 30 30 30 30 30 30
30 30 30 30 30 30 30 30 30 30 30 30 30 30 30 30 30 30 30 30 30 30 30 30 30 30 35 33 34 25 25 25 25 25 25 25 25 25 25 25 25 25 25 25 25 25 25 25 25 25 25 25 25 25 25 25 25 32 33 36 30 30 30 30 30 30 30 30 30 30 30 30 30 30 30 30 30 30 30 30 30 30 30 30 30 30 30 30 30 30 30 30 30 30 30 30 30 30 30 30
30 30 30 30 30 30 30 30 30 30 30 30 30 30 30 30 30 30 30 30 30 30 30 30 30 35 34 25 25 25 24 25 25 25 25 25 25 25 25 25 25 25 25 25 25 22 25 25 25 25 25 25 25 25 25 25 25 25 25 32 36 30 30 30 30 30 30 30 30 30 30 30 30 30 30 30 30 30 30 30 30 30 30 30 30 30 30 30 30 30 30 30 30 30 30 30 30 30 30 30
30 30 30 30 30 30 30 30 30 30 30 30 30 30 30 30 30 30 30 30 35 33 33 33 33 34 25 25 25 25 25 25 25 25 25 25 25 25 25 25 25 25 25 25 25 25 25 25 25 25 25 25 25 25 25 25 25 25 25 25 32 33 33 36 30 30 30 30 30 30 30 30 30 30 30 30 30 30 30 30 30 30 30 30 30 30 30 30 30 30 30 30 30 30 30 30 30 30 30 30
30 30 30 30 30 30 30 30 30 30 30 30 30 30 30 30 30 30 35 33 34 25 25 25 25 25 25 25 25 25 25 25 25 25 25 25 25 25 25 25 25 25 25 25 25 25 25 25 25 25 25 25 25 25 25 25 25 25 25 25 25 25 25 32 36 30 30 30 30 30 30 30 30 30 30 30 30 30 30 30 30 30 30 30 30 30 30 30 30 30 30 30 30 30 30 30 30 30 30 30
30 30 30 30 30 30 30 30 30 30 30 30 30 30 30 30 30 35 34 25 25 25 25 25 25 25 25 25 25 20 18 18 18 19 25 25 25 25 23 25 25 25 25 25 25 25 25 25 25 25 25 25 25 25 25 25 25 25 25 25 25 25 25 25 32 33 36 30 30 30 30 30 30 30 30 30 30 30 30 30 30 30 30 30 30 30 30 30 30 30 30 30 30 30 30 30 30 30 30 30
30 30 30 30 30 30 30 30 30 30 30 30 30 30 30 30 30 31 25 25 25 22 25 25 25 25 25 25 25 13 3 3 8 12 25 25 25 25 25 25 25 25 25 25 25 25 24 25 25 25 25 25 25 25 25 25 25 25 25 25 25 25 25 25 25 25 32 36 30 30 30 30 30 30 30 30 30 30 30 30 30 30 30 30 30 30 30 30 30 30 30 30 30 30 30 30 30 30 30 30
30 30 30 30 30 30 30 30 30 30 30 30 30 30 30 30 35 34 25 25 25 25 25 25 25 25 25 25 20 21 7 5 7 12 25 25 25 25 25 25 25 25 25 25 25 25 25 25 25 25 25 25 25 25 25 25 25 25 25 25 25 25 25 25 25 25 25 32 33 36 30 30 30 30 30 30 30 30 30 30 30 30 30 30 30 30 30 30 30 30 30 30 30 30 30 30 30 30 30 30
30 30 30 30 30 30 30 30 30 30 30 30 30 30 30 35 34 25 25 25 25 25 25 25 25 25 25 25 13 1 2 1 10 15 25 25 25 25 25 25 25 25 25 25 25 25 25 25 25 25 25 25 25 25 25 25 25 25 24 25 25 25 25 25 25 25 25 25 25 32 36 30 30 30 30 30 30 30 30 30 30 30 30 30 30 30 30 30 30 30 30 30 30 30 30 30 30 30 30 30
30 30 30 30 30 30 30 30 30 30 30 30 30 30 30 31 25 25 25 25 25 25 25 25 25 25 25 25 16 14 14 14 15 25 25 25 25 25 25 25 25 25 25 25 25 25 25 25 25 25 25 25 25 25 25 25 25 25 25 25 25 25 25 25 25 25 25 25 25 25 32 36 30 30 30 30 30 30 30 30 30 30 30 30 30 30 30 30 30 30 30 30 30 30 30 30 30 30 30 30
30 30 30 30 30 30 30 30 30 30 30 30 30 30 35 34 25 25 25 25 25 25 25 25 25 25 25 25 25 25 25 25 25 25 25 25 25 25 25 25 25 25 25 25 25 25 25 25 25 25 25 25 25 25 25 25 25 25 25 25 25 25 25 25 25 25 25 25 25 25 25 32 36 30 30 30 30 30 30 30 30 30 30 30 30 30 30 30 30 30 30 30 30 30 30 30 30 30 30 30
30 30 30 30 30 30 30 30 30 30 30 30 30 30 31 25 25 25 25 25 25 25 25 25 25 25 25 25 25 25 25 25 25 25 25 25 25 25 25 25 25 25 25 25 25 25 25 25 25 25 25 25 25 25 25 25 25 25 25 25 25 25 25 25 25 25 25 25 25 25 25 25 32 36 30 30 30 30 30 30 30 30 30 30 30 30 30 30 30 30 30 30 30 30 30 30 30 30 30 30
30 30 30 30 30 30 30 30 30 30 30 30 30 35 34 25 25 25 25 25 25 25 25 25 20 18 18 18 18 18 18 18 19 25 25 25 25 25 25 25 25 25 25 25 25 25 25 25 25 25 25 25 25 25 25 25 25 25 25 25 25 25 25 25 25 25 25 25 25 25 25 25 25 29 30 30 30 30 30 30 30 30 30 30 30 30 30 30 30 30 30 30 30 30 30 30 30 30 30 30
30 30 30 30 30 30 30 30 30 30 30 30 35 34 25 25 25 25 25 25 25 25 25 20 21 1 8 9 9 9 9 9 17 19 25 25 25 25 25 25 25 25 25 25 25 25 25 25 25 25 25 25 25 25 25 25 25 25 25 23 25 25 25 25 25 25 25 25 25 25 25 25 25 32 36 30 30 30 30 30 30 30 30 30 30 30 30 30 30 30 30 30 30 30 30 30 30 30 30 30
30 30 30 30 30 30 30 30 30 30 30 30 31 25 25 25 25 25 25 25 25 25 20 21 7 2 9 9 9 9 9 9 8 17 19 25 25 25 25 25 25 25 25 25 25 25 22 25 25 25 25 25 25 25 25 25 25 25 25 25 25 25 25 25 25 25 25 25 25 25 25 25 25 25 29 30 30 30 30 30 30 30 30 30 30 30 30 30 30 30 30 30 30 30 30 30 30 30 30 30
30 30 30 30 30 30 30 30 30 30 30 35 34 25 25 25 23 25 25 25 25 20 21 5 9 9 9 9 9 9 9 7 4 2 17 19 25 25 25 25 25 25 25 25 25 25 25 25 25 25 25 25 25 25 25 25 25 25 25 25 25 25 25 25 25 25 25 25 25 22 25 25 25 25 32 36 30 30 30 30 30 30 30 30 30 30 30 30 30 30 30 30 30 30 30 30 30 30 30 30
30 30 30 30 30 30 30 30 30 30 30 31 25 25 25 25 25 25 25 25 25 13 7 9 9 9 9 9 9 9 9 9 9 9 9 17 19 25 25 25 25 25 25 25 25 25 25 25 25 25 25 20 18 18 18 18 18 18 18 18 18 19 25 25 25 25 25 25 25 25 25 25 25 25 25 29 30 30 30 30 30 30 30 30 30 30 30 30 30 30 30 30 30 30 30 30 30 30 30 30
30 30 30 30 30 30 30 30 30 30 30 31 25 25 25 25 25 25 25 25 25 13 8 9 9 9 9 9 9 9 9 9 9 9 9 9 12 25 20 18 18 18 18 19 25 25 25 25 25 20 18 21 8 7 9 9 9 9 9 6 8 17 18 19 25 25 25 25 25 25 25 25 25 25 25 29 30 30 30 30 30 30 30 30 30 30 30 30 30 30 30 30 30 30 30 30 30 30 30 30
30 30 30 30 30 30 30 30 30 30 30 31 25 25 25 25 25 25 25 25 25 13 2 7 9 9 9 9 9 9 9 9 9 9 9 9 17 18 21 7 6 9 8 17 18 18 19 25 20 21 8 6 9 9 9 9 9 9 9 9 6 7 8 17 19 25 25 25 25 25 25 25 25 25 25 29 30 30 30 30 30 30 30 30 30 30 30 30 30 30 30 30 30 30 30 30 30 30 30 30
30 30 30 30 30 30 30 30 30 30 30 31 25 25 25 25 25 25 25 25 25 13 9 9 9 9 9 9 9 9 9 9 9 9 9 9 9 5 6 6 4 8 3 9 9 8 17 18 21 9 9 9 9 9 9 9 9 9 9 9 9 9 9 3 17 19 25 25 25 25 25 25 25 25 25 29 30 30 30 30 30 30 30 30 30 30 30 30 30 30 30 30 30 30 30 30 30 30 30 30
30 30 30 30 30 30 30 30 30 30 30 31 25 25 25 25 25 25 25 25 25 13 9 9 9 9 9 9 9 9 9 9 9 9 9 9 4 10 11 8 3 6 9 9 9 9 9 5 9 9 9 9 9 9 9 9 9 9 9 9 9 9 9 9 3 17 18 19 25 25 25 25 25 25 25 29 30 30 30 30 30 30 30 30 30 30 30 30 30 30 30 30 30 30 30 30 30 30 30 30
30 30 30 30 30 30 30 30 30 30 30 31 25 25 25 25 25 25 25 25 25 13 9 9 7 9 9 9 9 9 9 9 9 9 9 9 10 15 16 14 14 14 11 7 9 9 9 7 8 9 9 9 9 9 9 9 9 9 9 9 9 9 9 9 9 9 3 12 25 25 25 25 25 25 26 38 30 30 30 30 30 30 30 30 30 30 30 30 30 30 30 30 30 30 30 30 30 30 30 30
30 30 30 30 30 30 30 30 30 30 30 31 25 25 25 25 22 25 25 25 25 13 9 9 4 6 9 9 9 9 9 9 9 9 9 10 15 25 25 25 25 25 16 14 14 14 14 14 14 11 9 9 9 9 9 9 9 9 9 9 9 9 9 9 9 9 9 12 25 25 25 25 25 25 29 30 30 30 30 30 30 30 30 30 30 30 30 30 30 30 30 30 30 30 30 30 30 30 30 30
30 30 30 30 30 30 30 30 30 30 30 37 28 25 25 25 25 23 25 25 25 16 11 9 9 8 2 9 9 9 9 9 9 9 10 15 25 25 25 25 25 25 25 25 25 25 25 25 25 16 11 9 9 9 9 9 9 9 9 9 9 9 9 9 9 9 9 12 25 25 25 25 25 25 29 30 30 30 30 30 30 30 30 30 30 30 30 30 30 30 30 30 30 30 30 30 30 30 30 30
30 30 30 30 30 30 30 30 30 30 30 30 31 25 25 25 25 25 25 25 25 25 16 11 9 6 1 9 9 9 9 9 9 10 15 25 25 25 25 25 25 25 25 25 25 22 25 25 25 25 16 11 8 9 9 9 9 9 9 9 9 9 9 9 9 9 9 12 25 25 25 25 25 26 38 30 30 30 30 30 30 30 30 30 30 30 30 30 30 30 30 30 30 30 30 30 30 30 30 30
30 30 30 30 30 30 30 30 30 30 30 30 31 25 25 25 25 25 25 25 25 25 25 16 11 9 9 9 9 9 9 9 10 15 25 25 25 25 25 25 25 25 25 25 25 25 25 25 25 25 25 16 11 4 9 9 9 9 9 9 9 9 9 9 9 9 8 12 25 25 23 25 25 29 30 30 30 30 30 30 30 30 30 30 30 30 30 30 30 30 30 30 30 30 30 30 30 30 30 30
30 30 30 30 30 30 30 30 30 30 30 30 37 28 25 25 25 25 25 25 25 25 25 25 16 14 14 14 14 14 14 14 15 25 25 25 25 25 25 25 25 25 25 25 25 25 25 25 25 25 25 25 16 11 8 9 9 9 9 9 9 9 9 9 9 9 10 15 25 25 25 25 26 38 30 30 30 30 30 30 30 30 30 30 30 30 30 30 30 30 30 30 30 30 30 30 30 30 30 30
30 30 30 30 30 30 30 30 30 30 30 30 30 31 25 25 25 25 25 25 25 25 25 25 25 25 25 25 25 25 25 25 25 25 25 25 25 26 27 27 27 27 27 27 27 27 27 27 28 25 25 25 25 16 11 4 9 9 9 9 9 9 9 9 9 9 12 25 25 25 25 25 29 30 30 30 30 30 30 30 30 30 30 30 30 30 30 30 30 30 30 30 30 30 30 30 30 30 30 30
30 30 30 30 30 30 30 30 30 30 30 30 30 31 25 25 25 25 25 25 24 25 25 25 25 25 25 25 25 25 25 25 25 25 26 27 27 38 30 30 30 30 30 30 30 30 30 30 37 27 28 25 25 25 16 11 9 9 9 9 9 9 9 9 9 10 15 25 25 25 25 25 29 30 30 30 30 30 30 30 30 30 30 30 30 30 30 30 30 30 30 30 30 30 30 30 30 30 30 30
30 30 30 30 30 30 30 30 30 30 30 30 30 37 28 25 25 25 25 25 25 25 25 25 25 25 25 25 25 25 25 26 27 27 38 30 30 30 30 30 30 30 30 30 30 30 30 30 30 30 37 28 25 25 25 16 11 9 9 9 9 9 9 9 8 12 25 25 25 25 25 25 29 30 30 30 30 30 30 30 30 30 30 30 30 30 30 30 30 30 30 30 30 30 30 30 30 30 30 30
30 30 30 30 30 30 30 30 30 30 30 30 30 30 37 28 25 25 25 25 25 25 25 25 25 25 25 25 25 26 27 38 30 30 30 30 30 30 30 30 30 30 30 30 30 30 30 30 30 30 30 37 28 25 25 25 16 11 8 9 9 9 9 3 10 25 25 25 25 25 25 25 29 30 30 30 30 30 30 30 30 30 30 30 30 30 30 30 30 30 30 30 30 30 30 30 30 30 30 30
30 30 30 30 30 30 30 30 30 30 30 30 30 30 30 37 28 25 25 25 25 25 22 25 25 25 26 27 27 38 30 30 30 30 30 30 30 30 30 30 30 30 30 30 30 30 30 30 30 30 30 30 31 25 25 25 25 16 11 9 9 9 4 10 25 25 25 25 25 25 25 25 32 36 30 30 30 30 30 30 30 30 30 30 30 30 30 30 30 30 30 30 30 30 30 30 30 30 30 30
30 30 30 30 30 30 30 30 30 30 30 30 30 30 30 30 37 27 27 28 25 25 25 25 26 27 38 30 30 30 30 30 30 30 30 30 30 30 30 30 30 30 30 30 30 30 30 30 30 30 30 30 31 25 25 25 25 25 13 8 9 5 10 15 25 25 25 25 25 25 25 25 25 32 36 30 30 30 30 30 30 30 30 30 30 30 30 30 30 30 30 30 30 30 30 30 30 30 30 30
30 30 30 30 30 30 30 30 30 30 30 30 30 30 30 30 30 30 30 37 27 27 27 27 38 30 30 30 30 30 30 30 30 30 30 30 30 30 30 30 30 30 30 30 30 30 30 30 30 30 30 30 31 25 25 25 25 25 13 1 9 3 12 25 25 25 25 25 25 25 25 25 25 25 32 33 36 30 30 30 30 30 30 30 30 30 30 30 30 30 30 30 30 30 30 30 30 30 30 30
30 30 30 30 30 30 30 30 30 30 30 30 30 30 30 30 30 30 30 30 30 30 30 30 30 30 30 30 30 30 30 30 30 30 30 30 30 30 30 30 30 30 30 30 30 30 30 30 30 30 30 30 31 25 25 25 25 25 13 5 6 8 12 25 25 25 25 25 25 25 25 25 25 25 25 25 32 33 36 30 30 30 30 30 30 30 30 30 30 30 30 30 30 30 30 30 30 30 30 30
30 30 30 30 30 30 30 30 30 30 30 30 30 30 30 30 30 30 30 30 30 30 30 30 30 30 30 30 30 30 30 30 30 30 30 30 30 30 30 30 30 30 30 30 30 30 30 30 30 30 30 30 31 25 25 25 25 25 13 5 9 2 12 25 25 25 25 25 25 25 22 25 25 25 25 25 25 25 32 33 36 30 30 30 30 30 30 30 30 30 30 30 30 30 30 30 30 30 30 30
30 30 30 30 30 30 30 30 30 30 30 30 30 30 30 30 30 30 30 30 30 30 30 30 30 30 30 30 30 30 30 30 30 30 30 30 30 30 30 30 30 30 30 30 30 30 30 30 30 30 30 35 34 25 25 22 25 20 21 8 9 5 12 25 20 18 18 18 19 25 25 25 25 25 25 25 25 25 25 25 32 33 33 36 30 30 30 30 30 30 30 30 30 30 30 30 30 30 30 30
30 30 30 30 30 30 30 30 30 30 30 30 30 30 30 30 30 30 30 30 30 30 30 30 30 30 30 30 30 30 30 30 30 30 30 30 30 30 30 30 30 30 30 30 30 30 30 30 30 30 30 31 25 25 25 25 25 13 9 9 9 9 17 19 13 8 6 7 17 19 25 25 25 25 25 25 25 23 25 25 25 25 25 32 33 33 36 30 30 30 30 30 30 30 30 30 30 30 30 30
30 30 30 30 30 30 30 30 30 30 30 30 30 30 30 30 30 30 30 30 30 30 30 30 30 30 30 30 30 30 30 30 30 30 30 30 30 30 30 30 30 30 30 30 30 30 30 30 30 30 35 34 25 25 25 20 18 21 7 9 9 9 7 17 21 3 9 9 2 17 18 18 18 18 18 18 18 18 19 25 25 25 25 25 25 25 32 33 36 30 30 30 30 30 30 30 30 30 30 30
30 30 30 30 30 30 30 30 30 30 30 30 30 30 30 30 30 30 30 30 30 30 30 30 30 30 30 30 30 30 30 30 30 30 30 30 30 30 30 30 30 30 30 30 30 30 30 30 30 30 31 25 25 25 20 21 3 5 9 9 9 9 9 9 9 9 9 9 9 9 9 9 9 9 9 8 4 3 17 19 25 25 25 25 25 22 25 25 32 33 33 36 30 30 30 30 30 30 30 30
30 30 30 30 30 30 30 30 30 30 30 30 30 30 30 30 30 30 30 30 30 30 30 30 30 30 30 30 30 30 30 30 30 30 30 30 30 30 30 30 30 30 30 30 30 30 30 30 30 35 34 25 25 25 13 5 9 9 9 9 9 9 9 9 9 9 9 9 9 9 9 9 9 9 9 9 9 9 4 17 18 18 18 18 19 25 25 24 25 25 25 32 33 33 36 30 30 30 30 30
30 30 30 30 30 30 30 30 30 30 30 30 30 30 30 30 30 30 30 30 30 30 30 30 30 30 30 30 30 30 30 30 30 30 30 30 30 30 30 30 30 30 30 30 30 30 30 35 33 34 25 25 25 20 21 9 9 9 9 9 9 9 9 9 9 9 9 9 9 9 9 9 9 9 9 9 9 9 9 9 9 9 7 4 17 19 25 25 25 25 25 25 25 25 32 33 33 33 36 30
30 30 30 30 30 30 30 30 30 30 30 30 30 30 30 30 30 30 30 30 30 30 30 30 30 30 30 30 30 30 30 30 30 30 30 30 30 30 30 30 30 30 30 30 35 33 33 34 25 25 25 25 25 13 5 9 9 9 9 9 9 9 9 3 3 9 9 9 9 9 9 9 9 9 9 9 9 9 9 9 9 9 9 8 4 17 18 18 18 18 18 19 25 24 25 25 25 25 32 36
30 30 30 30 30 30 30 30 30 30 30 30 30 30 30 30 30 30 30 30 30 30 30 30 30 30 30 30 30 30 30 30 30 30 30 30 30 30 30 30 30 30 35 33 34 25 25 25 25 25 25 25 20 21 9 9 9 9 9 9 9 9 3 10 11 8 9 9 9 9 9 9 10 14 14 14 11 7 4 9 9 9 9 9 9 9 9 9 9 5 7 17 18 18 18 18 18 19 25 29
30 30 30 30 30 30 30 30 30 30 30 30 30 30 30 30 30 30 30 30 30 30 30 30 30 30 30 30 30 30 30 30 30 30 30 30 30 35 33 33 33 33 34 25 25 25 25 25 25 25 20 18 21 7 9 9 9 9 9 9 9 9 7 12 16 14 11 8 6 9 9 9 17 18 19 25 16 11 7 9 9 9 9 9 9 9 9 9 9 9 9 9 9 8 5 9 8 17 18 29
30 30 30 30 30 30 30 30 30 30 30 30 30 30 30 30 30 30 30 30 30 30 30 30 30 30 30 30 30 30 30 30 30 30 35 33 33 34 25 25 25 25 25 25 25 25 25 25 20 18 21 9 9 9 9 9 9 9 9 9 9 9 9 12 25 25 16 14 11 6 9 9 9 8 17 19 24 25 11 4 9 9 9 9 9 9 9 9 9 9 9 9 9 9 4 9 9 9 8 29
30 30 30 30 30 30 30 30 30 30 30 30 30 30 30 30 30 30 30 30 30 30 30 30 30 30 30 30 30 30 30 30 30 30 34 25 25 25 25 25 25 25 22 25 25 25 20 18 21 7 9 9 9 9 9 9 9 7 10 14 11 4 7 12 25 25 25 25 16 11 1 9 9 9 9 17 18 19 16 14 11 9 9 9 9 9 9 9 9 9 9 9 9 9 1 6 4 9 9 29
30 30 30 30 30 30 30 30 30 30 30 30 30 30 30 30 30 30 30 30 30 30 30 30 30 30 30 30 30 30 30 30 30 31 25 25 25 25 25 25 25 25 20 18 18 18 21 7 6 9 9 9 9 9 9 9 9 10 15 20 21 8 10 15 25 25 25 25 25 16 11 6 9 9 9 9 9 17 19 25 21 9 9 9 9 9 9 9 9 9 9 9 9 9 9 7 5 8 9 29
30 30 30 30 30 30 30 30 30 30 30 30 30 30 30 30 30 30 30 30 30 30 30 30 30 30 30 30 30 30 30 30 35 34 25 25 25 25 25 25 25 20 21 2 9 9 9 9 9 9 9 9 9 9 9 9 9 12 20 21 4 10 15 25 25 25 25 25 25 25 16 11 1 6 9 9 8 9 17 21 8 9 9 9 9 9 9 9 9 9 9 9 9 9 9 9 9 9 9 29
30 30 30 30 30 30 30 30 30 30 30 30 30 30 30 30 30 30 30 30 30 30 30 30 30 30 30 30 30 30 30 30 31 25 25 20 18 18 18 18 18 21 8 6 9 9 9 9 9 9 9 9 9 9 9 9 4 17 21 4 10 15 25 23 25 25 25 25 25 25 25 16 14 11 9 9 9 9 9 9 9 9 9 9 9 9 9 9 9 9 9 9 9 9 9 9 9 9 9 29
35 33 33 33 33 33 33 33 33 33 33 33 33 33 33 33 33 33 33 33 36 30 30 30 30 30 30 30 30 30 30 35 34 25 20 21 7 9 9 9 9 9 9 9 9 9 9 9 9 9 9 9 9 9 4 10 14 14 14 14 15 25 25 24 25 25 25 25 22 25 25 20 18 21 9 9 9 9 9 9 9 9 9 9 9 9 9 9 9 9 9 9 9 9 9 9 9 4 9 29
31 22 25 25 25 25 25 25 25 25 25 25 25 25 25 25 22 25 25 25 32 33 33 36 30 30 30 35 33 33 33 34 25 25 13 8 4 9 9 9 9 9 9 9 9 9 9 9 9 9 9 9 9 4 10 15 25 25 25 25 25 25 25 25 25 25 25 25 25 20 18 21 9 9 9 9 9 9 9 9 9 9 9 9 9 9 9 9 9 9 9 9 9 4 7 9 9 6 3 29
31 25 25 25 25 20 18 18 18 18 19 25 25 25 25 25 25 25 25 25 25 25 25 32 33 33 33 34 25 25 25 25 25 25 13 4 9 9 9 9 9 9 9 9 9 9 9 9 9 9 6 10 14 14 15 25 25 25 25 25 25 25 25 25 25 25 25 20 18 21 9 9 9 9 9 9 9 9 9 9 9 9 9 9 9 9 9 9 9 9 9 9 9 9 6 4 9 3 8 29
31 18 18 18 18 21 8 4 6 7 17 18 18 18 18 18 18 18 18 18 18 18 19 25 25 25 25 25 25 25 25 25 25 20 21 9 9 9 9 9 9 9 9 9 9 9 9 9 6 10 14 15 25 25 25 25 25 25 22 25 25 25 25 25 25 20 18 21 6 9 9 9 9 9 9 9 9 9 9 9 9 9 9 9 9 9 9 9 9 9 9 9 9 9 5 3 9 9 9 29
31 5 8 9 9 9 9 9 9 9 9 9 9 9 9 9 9 9 9 9 6 8 17 19 25 25 25 25 25 25 25 25 20 21 7 9 9 9 9 9 9 9 9 9 9 9 10 14 14 15 25 25 25 25 25 25 25 25 25 25 25 25 25 20 18 21 3 5 8 9 9 9 9 9 9 9 9 9 9 9 9 9 9 9 9 3 10 14 14 14 14 14 14 14 14 14 11 7 3 29
31 9 9 9 9 9 9 9 9 9 9 9 9 9 9 9 9 9 9 9 9 6 8 17 19 25 23 25 25 25 25 20 21 9 9 9 9 9 9 9 9 9 9 9 9 6 12 25 25 25 25 25 25 25 25 25 25 25 25 25 25 20 18 21 9 9 9 9 9 9 9 9 9 9 9 9 9 9 9 9 9 9 9 9 8 10 15 25 25 25 25 25 25 25 25 25 16 14 14 29
31 7 9 9 6 8 6 9 9 9 9 9 9 9 9 9 9 9 9 9 9 9 6 2 17 18 18 18 18 18 18 21 1 9 9 9 9 9 9 9 9 9 9 9 8 10 15 25 25 25 25 25 25 25 25 25 25 25 25 20 18 21 9 9 9 9 9 9 9 9 9 9 9 9 9 9 9 9 9 9 9 9 9 6 10 15 25 25 23 25 25 25 22 25 25 25 25 25 25 29
31 14 14 14 14 14 11 2 9 9 3 7 9 9 9 9 9 9 9 9 9 9 9 9 9 9 9 9 9 9 9 9 9 9 9 9 9 9 9 9 9 9 9 6 10 15 25 25 23 25 25 25 25 25 25 25 25 20 18 21 9 9 9 9 9 9 9 9 9 9 9 9 9 9 9 9 9 9 9 9 9 4 7 10 15 25 25 25 26 27 27 27 27 27 27 27 27 27 27 38
31 25 25 25 25 25 16 14 14 14 11 4 9 9 9 9 9 9 9 9 9 9 9 9 9 9 9 9 9 9 9 9 9 9 9 9 9 9 9 6 4 9 8 10 15 25 25 25 24 25 25 25 25 25 25 20 18 21 9 9 9 9 9 9 9 9 9 9 9 9 9 9 9 9 9 9 6 7 10 14 14 14 14 15 25 25 26 27 38 30 30 30 30 30 30 30 30 30 30 30
31 25 25 25 25 25 25 25 25 25 16 14 14 14 14 14 11 7 8 4 9 9 9 9 9 9 9 9 9 9 9 9 9 9 9 9 9 9 6 4 10 14 14 15 25 25 22 25 25 25 25 25 25 20 18 21 3 9 9 9 9 9 9 9 9 9 9 9 9 4 10 14 14 14 14 14 14 14 15 25 25 25 25 25 25 24 29 30 30 30 30 30 30 30 30 30 30 30 30 30
37 27 27 27 27 27 28 25 25 23 25 25 25 25 25 25 16 14 11 7 4 9 9 9 9 9 9 9 9 9 9 9 9 9 4 10 14 14 14 14 15 25 25 25 25 25 25 25 25 25 25 20 18 21 3 8 9 9 9 9 9 9 9 9 9 9 9 4 7 8 12 25 25 25 25 25 25 25 25 25 25 25 25 25 26 27 38 30 30 30 30 30 30 30 30 30 30 30 30 30
30 30 30 30 30 30 37 27 28 25 25 25 25 25 24 25 25 25 16 14 11 9 9 9 9 9 9 9 9 9 9 9 8 4 10 15 25 25 25 25 25 25 25 25 25 25 25 25 20 18 18 21 3 9 9 9 9 9 9 9 9 9 9 9 9 9 4 10 14 14 15 25 25 25 25 22 25 25 25 25 25 26 27 27 38 30 30 30 30 30 30 30 30 30 30 30 30 30 30 30
30 30 30 30 30 30 30 30 37 27 27 27 27 27 27 27 28 25 25 25 13 9 9 9 9 9 9 9 9 9 9 4 10 14 15 25 25 25 25 25 25 25 25 25 25 20 18 18 21 3 7 9 9 9 9 9 9 9 9 9 9 5 10 14 14 14 14 15 25 25 25 25 25 25 26 27 27 27 27 27 27 38 30 30 30 30 30 30 30 30 30 30 30 30 30 30 30 30 30 30
30 30 30 30 30 30 30 30 30 30 30 30 30 30 30 30 31 25 25 25 13 9 9 9 9 9 9 9 4 8 10 14 15 25 25 25 25 25 25 25 25 20 18 18 18 21 7 9 9 9 9 9 9 9 9 9 9 9 9 9 9 6 12 25 25 25 25 25 25 25 25 26 27 27 38 30 30 30 30 30 30 30 30 30 30 30 30 30 30 30 30 30 30 30 30 30 30 30 30 30
30 30 30 30 30 30 30 30 30 30 30 30 30 30 30 30 37 28 25 24 13 9 9 9 9 9 9 10 14 14 15 23 25 25 25 25 20 18 18 18 18 21 3 8 9 9 9 9 9 9 9 9 9 9 9 9 9 9 6 10 14 14 15 25 25 23 25 25 26 27 27 38 30 30 30 30 30 30 30 30 30 30 30 30 30 30 30 30 30 30 30 30 30 30 30 30 30 30 30 30
30 30 30 30 30 30 30 30 30 30 30 30 30 30 30 30 30 31 25 25 13 9 9 9 9 9 9 17 18 18 18 18 18 18 18 18 21 3 9 9 9 9 9 9 9 9 9 9 9 9 9 9 9 9 9 9 9 7 8 12 25 25 25 25 25 25 26 27 38 30 30 30 30 30 30 30 30 30 30 30 30 30 30 30 30 30 30 30 30 30 30 30 30 30 30 30 30 30 30 30
30 30 30 30 30 30 30 30 30 30 30 30 30 30 30 30 30 31 25 25 13 9 9 9 9 9 9 9 9 9 9 9 9 9 9 9 9 9 9 9 9 9 9 9 9 9 9 9 9 9 9 9 9 9 9 9 4 10 14 15 25 25 25 25 26 27 38 30 30 30 30 30 30 30 30 30 30 30 30 30 30 30 30 30 30 30 30 30 30 30 30 30 30 30 30 30 30 30 30 30
30 30 30 30 30 30 30 30 30 30 30 30 30 30 30 30 30 31 25 25 13 9 9 9 9 9 9 9 9 9 9 9 9 9 9 9 9 9 9 9 9 9 9 9 9 9 9 9 4 4 10 14 14 14 14 14 14 15 25 25 25 25 25 25 29 30 30 30 30 30 30 30 30 30 30 30 30 30 30 30 30 30 30 30 30 30 30 30 30 30 30 30 30 30 30 30 30 30 30 30
30 30 30 30 30 30 30 30 30 30 30 30 30 30 30 30 30 31 25 25 13 9 9 9 9 9 9 9 9 9 9 9 9 9 9 9 9 9 9 9 9 9 9 9 9 9 6 8 6 10 15 25 25 25 25 25 25 25 25 25 25 25 26 27 38 30 30 30 30 30 30 30 30 30 30 30 30 30 30 30 30 30 30 30 30 30 30 30 30 30 30 30 30 30 30 30 30 30 30 30
30 30 30 30 30 30 30 30 30 30 30 30 30 30 30 30 30 31 25 25 21 9 9 9 9 9 9 9 9 9 9 9 9 9 9 9 9 9 9 9 5 10 14 14 14 14 14 14 14 15 25 25 25 24 25 25 25 25 25 25 26 27 38 30 30 30 30 30 30 30 30 30 30 30 30 30 30 30 30 30 30 30 30 30 30 30 30 30 30 30 30 30 30 30 30 30 30 30 30 30
30 30 30 30 30 30 30 30 30 30 30 30 30 30 30 30 35 34 25 13 8 9 9 9 9 9 9 9 9 9 9 9 9 9 9 9 9 9 9 6 8 12 25 25 25 25 25 25 25 25 25 25 25 25 25 26 27 27 27 27 38 30 30 30 30 30 30 30 30 30 30 30 30 30 30 30 30 30 30 30 30 30 30 30 30 30 30 30 30 30 30 30 30 30 30 30 30 30 30 30
30 30 30 30 30 30 30 30 30 30 30 30 30 30 30 30 31 25 25 13 6 2 9 9 9 9 9 9 9 9 9 9 9 9 9 8 10 14 14 14 14 15 25 25 25 25 25 25 25 25 25 26 27 27 27 38 30 30 30 30 30 30 30 30 30 30 30 30 30 30 30 30 30 30 30 30 30 30 30 30 30 30 30 30 30 30 30 30 30 30 30 30 30 30 30 30 30 30 30 30
30 30 30 30 30 30 30 30 30 30 30 30 30 30 30 30 31 25 25 16 11 1 2 9 9 9 9 9 9 9 9 9 9 9 4 4 12 25 25 25 25 25 25 22 25 25 25 25 26 27 27 38 30 30 30 30 30 30 30 30 30 30 30 30 30 30 30 30 30 30 30 30 30 30 30 30 30 30 30 30 30 30 30 30 30 30 30 30 30 30 30 30 30 30 30 30 30 30 30 30
30 30 30 30 30 30 30 30 30 30 30 30 30 30 30 30 31 25 25 25 16 11 4 9 9 9 9 9 9 9 9 7 8 10 14 14 15 25 25 25 25 25 25 25 25 25 26 27 38 30 30 30 30 30 30 30 30 30 30 30 30 30 30 30 30 30 30 30 30 30 30 30 30 30 30 30 30 30 30 30 30 30 30 30 30 30 30 30 30 30 30 30 30 30 30 30 30 30 30 30
30 30 30 30 30 30 30 30 30 30 30 30 30 30 30 30 31 25 25 25 25 16 14 11 9 9 9 9 9 9 4 10 14 15 25 25 25 25 25 25 25 25 25 25 26 27 38 30 30 30 30 30 30 30 30 30 30 30 30 30 30 30 30 30 30 30 30 30 30 30 30 30 30 30 30 30 30 30 30 30 30 30 30 30 30 30 30 30 30 30 30 30 30 30 30 30 30 30 30 30
30 30 30 30 30 30 30 30 30 30 30 30 30 30 30 30 37 28 25 25 25 25 25 13 7 9 9 9 9 5 10 15 25 25 25 25 25 23 25 25 26 27 27 27 38 30 30 30 30 30 30 30 30 30 30 30 30 30 30 30 30 30 30 30 30 30 30 30 30 30 30 30 30 30 30 30 30 30 30 30 30 30 30 30 30 30 30 30 30 30 30 30 30 30 30 30 30 30 30 30
30 30 30 30 30 30 30 30 30 30 30 30 30 30 30 30 30 37 28 25 25 24 25 16 11 6 9 6 10 14 15 25 24 25 25 25 25 26 27 27 38 30 30 30 30 30 30 30 30 30 30 30 30 30 30 30 30 30 30 30 30 30 30 30 30 30 30 30 30 30 30 30 30 30 30 30 30 30 30 30 30 30 30 30 30 30 30 30 30 30 30 30 30 30 30 30 30 30 30 30
30 30 30 30 30 30 30 30 30 30 30 30 30 30 30 30 30 30 31 25 25 25 25 25 16 11 8 10 15 25 25 25 25 25 26 27 27 38 30 30 30 30 30 30 30 30 30 30 30 30 30 30 30 30 30 30 30 30 30 30 30 30 30 30 30 30 30 30 30 30 30 30 30 30 30 30 30 30 30 30 30 30 30 30 30 30 30 30 30 30 30 30 30 30 30 30 30 30 30 30
30 30 30 30 30 30 30 30 30 30 30 30 30 30 30 30 30 30 31 25 25 25 25 25 22 16 14 15 25 25 25 25 25 26 38 30 30 30 30 30 30 30 30 30 30 30 30 30 30 30 30 30 30 30 30 30 30 30 30 30 30 30 30 30 30 30 30 30 30 30 30 30 30 30 30 30 30 30 30 30 30 30 30 30 30 30 30 30 30 30 30 30 30 30 30 30 30 30 30 30
30 30 30 30 30 30 30 30 30 30 30 30 30 30 30 30 30 30 31 25 25 25 25 25 25 25 25 25 25 25 25 25 26 38 30 30 30 30 30 30 30 30 30 30 30 30 30 30 30 30 30 30 30 30 30 30 30 30 30 30 30 30 30 30 30 30 30 30 30 30 30 30 30 30 30 30 30 30 30 30 30 30 30 30 30 30 30 30 30 30 30 30 30 30 30 30 30 30 30 30
30 30 30 30 30 30 30 30 30 30 30 30 30 30 30 30 30 30 37 28 25 25 25 25 25 25 25 25 25 25 25 26 38 30 30 30 30 30 30 30 30 30 30 30 30 30 30 30 30 30 30 30 30 30 30 30 30 30 30 30 30 30 30 30 30 30 30 30 30 30 30 30 30 30 30 30 30 30 30 30 30 30 30 30 30 30 30 30 30 30 30 30 30 30 30 30 30 30 30 30
30 30 30 30 30 30 30 30 30 30 30 30 30 30 30 30 30 30 30 37 27 28 25 25 25 25 25 25 25 26 27 38 30 30 30 30 30 30 30 30 30 30 30 30 30 30 30 30 30 30 30 30 30 30 30 30 30 30 30 30 30 30 30 30 30 30 30 30 30 30 30 30 30 30 30 30 30 30 30 30 30 30 30 30 30 30 30 30 30 30 30 30 30 30 30 30 30 30 30 30
30 30 30 30 30 30 30 30 30 30 30 30 30 30 30 30 30 30 30 30 30 37 27 27 27 27 27 27 27 38 30 30 30 30 30 30 30 30 30 30 30 30 30 30 30 30 30 30 30 30 30 30 30 30 30 30 30 30 30 30 30 30 30 30 30 30 30 30 30 30 30 30 30 30 30 30 30 30 30 30 30 30 30 30 30 30 30 30 30 30 30 30 30 30 30 30 30 30 30 30
30 30 30 30 30 30 30 30 30 30 30 30 30 30 30 30 30 30 30 30 30 30 30 30 30 30 30 30 30 30 30 30 30 30 30 30 30 30 30 30 30 30 30 30 30 30 30 30 30 30 30 30 30 30 30 30 30 30 30 30 30 30 30 30 30 30 30 30 30 30 30 30 30 30 30 30 30 30 30 30 30 30 30 30 30 30 30 30 30 30 30 30 30 30 30 30 30 30 30 30