30 30 30 30 30 30 30 30 30 30 30 30 30 30 30 30 30 30 30 30 30 30 30 30 30 30 30 30 30 30 30 30 30 30 30 30 30 30 30 30 30 30 30 30 30 30 30 30 30 30
30 30 30 30 30 30 30 30 30 30 30 30 30 30 30 30 30 30 30 30 30 30 30 30 30 30 30 30 30 30 30 30 30 30 30 30 30 30 30 30 30 30 30 30 30 30 30 30 30 30
30 30 30 30 30 30 30 30 30 30 30 30 30 30 30 30 30 30 30 30 30 30 30 30 30 30 30 30 30 30 30 30 30 30 30 30 30 30 30 30 30 30 30 30 30 30 30 30 30 30
30 30 30 30 30 30 30 30 30 30 30 30 30 30 30 30 30 30 35 33 33 36 30 30 30 30 30 30 30 30 30 30 30 30 30 30 30 30 30 30 30 30 30 30 30 30 30 30 30 30
30 30 30 30 30 30 30 30 30 30 30 30 30 30 35 33 33 33 34 25 25 32 33 33 33 36 30 30 30 35 33 33 36 30 30 30 30 30 30 30 30 30 30 30 30 30 30 30 30 30
30 30 30 30 30 30 30 30 30 30 30 30 30 35 34 25 25 25 25 25 25 25 25 25 25 32 33 33 33 34 25 25 32 33 33 36 30 30 30 30 30 30 30 30 30 30 30 30 30 30
30 30 30 30 30 30 30 30 30 30 30 30 35 34 25 25 25 25 23 25 25 25 24 22 25 25 25 24 25 25 25 25 25 25 25 32 33 36 30 30 30 30 30 30 30 30 30 30 30 30
30 30 30 30 30 30 30 30 30 30 30 30 31 25 25 25 23 25 25 24 25 25 25 25 25 25 25 25 24 25 25 25 25 25 25 25 25 29 30 30 30 30 30 30 30 30 30 30 30 30
30 30 30 30 30 30 30 30 30 30 30 35 34 25 25 23 22 25 25 20 18 18 18 18 18 18 18 18 18 19 25 25 25 25 23 25 25 32 36 30 30 30 30 30 30 30 30 30 30 30
30 30 30 30 30 30 30 30 30 30 30 31 25 25 25 24 25 25 20 21 7 4 9 9 9 9 9 2 1 17 19 25 25 25 25 24 25 25 29 30 30 30 30 30 30 30 30 30 30 30
30 30 30 30 30 30 30 30 30 30 35 34 25 25 25 25 25 25 13 8 4 9 9 9 9 9 9 9 4 8 17 19 25 25 22 25 25 25 29 30 30 30 30 30 30 30 30 30 30 30
30 30 30 30 30 30 30 30 30 30 31 25 25 20 18 19 25 25 13 4 9 9 9 9 9 9 9 9 9 6 1 12 25 25 25 25 25 25 29 30 30 30 30 30 30 30 30 30 30 30
30 30 30 30 30 30 30 30 30 30 31 23 25 13 4 12 25 20 21 9 9 9 9 9 9 9 9 9 9 9 6 12 25 24 25 25 25 25 29 30 30 30 30 30 30 30 30 30 30 30
30 30 30 30 30 30 30 30 30 30 31 25 22 13 7 12 20 21 7 9 9 9 9 9 9 9 9 9 9 9 9 12 25 25 22 25 25 25 29 30 30 30 30 30 30 30 30 30 30 30
30 30 30 30 30 30 30 30 30 30 31 25 23 13 8 12 13 3 8 9 9 9 9 9 9 9 9 9 9 9 9 12 25 25 23 25 25 26 38 30 30 30 30 30 30 30 30 30 30 30
30 30 30 30 30 30 30 30 30 30 37 28 25 16 14 15 13 1 3 3 9 9 9 9 9 9 9 9 9 9 7 12 25 25 25 25 25 29 30 30 30 30 30 30 30 30 30 30 30 30
30 30 30 30 30 30 30 30 30 30 30 31 25 25 25 23 25 10 7 9 9 9 9 9 9 9 9 9 9 6 4 12 22 25 22 25 26 38 30 30 30 30 30 30 30 30 30 30 30 30
30 30 30 30 30 30 30 30 30 30 30 37 27 28 25 22 24 13 8 9 9 9 9 9 9 9 9 9 4 8 11 15 25 23 25 25 29 30 30 30 35 33 33 36 30 30 30 30 30 30
30 30 30 30 30 30 30 30 30 30 30 30 30 31 25 25 20 21 4 7 9 9 9 9 9 9 9 9 1 11 15 25 25 25 25 26 38 30 35 33 34 25 25 32 33 33 33 33 33 36
30 30 30 30 30 30 30 30 30 30 30 30 30 37 27 28 16 14 14 10 9 9 9 9 9 9 9 8 11 15 22 25 25 25 26 38 30 35 34 25 25 25 25 25 25 25 25 25 25 32
33 33 33 33 33 33 33 33 33 33 33 33 33 33 33 34 24 22 20 21 9 9 9 9 9 9 4 11 15 25 23 22 25 25 32 33 33 34 25 25 25 25 25 25 25 25 23 25 25 25
25 25 25 25 25 25 25 25 25 25 25 25 25 25 25 25 25 20 21 1 9 9 9 9 9 9 7 17 18 19 25 24 25 25 25 25 20 18 18 18 18 18 19 25 25 25 25 22 25 25
25 25 25 25 25 25 25 25 22 25 25 25 25 25 25 20 18 21 1 3 9 9 9 9 9 9 9 7 4 12 25 25 25 20 18 18 21 7 9 9 3 8 17 18 19 20 18 19 25 25
25 25 25 25 25 25 25 23 20 18 18 18 18 18 18 21 8 6 9 9 9 9 9 9 9 9 9 9 4 17 18 18 18 21 4 8 9 9 9 9 9 4 1 8 17 21 7 17 18 18
18 18 18 18 18 18 18 18 21 7 4 9 9 6 8 4 9 9 9 9 9 9 9 9 9 9 9 9 9 9 9 9 9 9 9 9 9 9 9 9 9 9 6 5 9 9 9 5 4 8
7 5 4 2 3 8 9 9 4 5 2 9 9 9 9 9 9 9 9 9 9 9 9 9 9 9 9 9 9 9 9 9 9 9 9 9 9 9 9 9 9 9 9 9 9 9 9 9 9 9
9 9 9 9 9 9 9 9 9 9 9 9 9 9 9 9 9 9 9 9 9 9 9 9 9 9 9 9 9 9 9 9 9 9 9 9 9 9 9 9 9 9 9 9 9 9 9 9 9 9
9 9 9 9 9 9 9 9 9 9 9 9 9 9 9 4 7 11 14 14 14 10 7 9 9 9 9 9 9 9 9 9 9 9 9 9 9 9 9 9 9 9 9 9 9 9 9 9 9 9
9 9 9 9 9 9 4 9 9 9 9 9 9 6 7 11 14 15 25 25 25 16 10 8 1 9 9 9 9 9 9 9 9 9 9 9 9 9 9 9 9 9 9 9 9 9 9 9 9 9
8 9 9 9 9 4 5 7 8 11 14 14 14 14 14 15 25 25 23 25 25 25 16 14 14 14 10 5 7 8 9 9 9 9 3 4 9 9 9 9 9 9 9 9 9 9 9 9 9 9
14 14 14 14 14 14 14 14 14 15 25 25 25 25 25 25 25 22 24 25 25 25 25 25 25 25 16 14 14 14 14 14 14 14 14 10 7 8 4 9 9 9 9 9 9 9 9 9 9 9
25 25 25 25 25 22 24 25 25 25 25 25 25 25 25 25 25 25 25 25 25 25 25 25 25 25 25 25 22 25 25 25 25 25 25 16 14 14 14 14 14 14 14 14 14 14 10 7 4 6
25 25 25 25 25 25 25 25 26 27 27 27 28 25 25 25 25 25 25 25 25 25 25 25 25 26 27 27 27 27 27 28 25 25 25 25 25 25 25 25 25 25 25 25 25 25 16 14 14 14
25 25 25 26 27 27 27 27 38 30 30 30 37 27 27 27 27 27 27 27 27 27 27 27 27 38 30 30 30 30 30 37 27 27 27 27 27 27 28 25 25 25 25 22 24 25 25 25 25 25
25 26 27 38 30 30 30 30 30 30 30 30 30 30 30 30 30 30 30 30 30 30 30 30 30 30 30 30 30 30 30 30 30 30 30 30 30 30 37 27 27 28 25 25 25 25 25 25 25 25
27 38 30 30 30 30 30 30 30 30 30 30 30 30 30 30 30 30 30 30 30 30 30 30 30 30 30 30 30 30 30 30 30 30 30 30 30 30 30 30 30 37 27 28 25 25 25 26 27 27
30 30 30 30 30 30 30 30 30 30 30 30 30 30 30 30 30 30 30 30 30 30 30 30 30 30 30 30 30 30 30 30 30 30 30 30 30 30 30 30 30 30 30 37 27 27 27 38 30 30
30 30 30 30 30 30 30 30 30 30 30 30 30 30 30 30 30 30 30 30 30 30 30 30 30 30 30 30 30 30 30 30 30 30 30 30 30 30 30 30 30 30 30 30 30 30 30 30 30 30
30 30 30 30 30 30 30 30 30 30 30 30 30 30 30 30 30 30 30 30 30 30 30 30 30 30 30 30 30 30 30 30 30 30 30 30 30 30 30 30 30 30 30 30 30 30 30 30 30 30
30 30 30 30 30 30 30 30 30 30 30 30 30 30 30 30 30 30 30 30 30 30 30 30 30 30 30 30 30 30 30 30 30 30 30 30 30 30 30 30 30 30 30 30 30 30 30 30 30 30
30 30 30 30 30 30 30 30 30 30 30 30 30 30 30 30 30 30 30 30 30 30 30 30 30 30 30 30 30 30 30 30 30 30 30 30 30 30 30 30 30 30 30 30 30 30 30 30 30 30
30 30 30 30 30 30 30 30 30 30 30 30 30 30 30 30 30 30 30 30 30 30 30 30 30 30 30 30 30 30 30 30 30 30 30 30 30 30 30 30 30 30 30 30 30 30 30 30 30 30
30 30 30 30 30 30 30 30 30 30 30 30 30 30 30 30 30 30 30 30 30 30 30 30 30 30 30 30 30 30 30 30 30 30 30 30 30 30 30 30 30 30 30 30 30 30 30 30 30 30
30 30 30 30 30 30 30 30 30 30 30 30 30 30 30 30 30 30 30 30 30 30 30 30 30 30 30 30 30 30 30 30 30 30 30 30 30 30 30 30 30 30 30 30 30 30 30 30 30 30
30 30 30 30 30 30 30 30 30 30 30 30 30 30 30 30 30 30 30 30 30 30 30 30 30 30 30 30 30 30 30 30 30 30 30 30 30 30 30 30 30 30 30 30 30 30 30 30 30 30
30 30 30 30 30 30 30 30 30 30 30 30 30 30 30 30 30 30 30 30 30 30 30 30 30 30 30 30 30 30 30 30 30 30 30 30 30 30 30 30 30 30 30 30 30 30 30 30 30 30
30 30 30 30 30 30 30 30 30 30 30 30 30 30 30 30 30 30 30 30 30 30 30 30 30 30 30 30 30 30 30 30 30 30 30 30 30 30 30 30 30 30 30 30 30 30 30 30 30 30
30 30 30 30 30 30 30 30 30 30 30 30 30 30 30 30 30 30 30 30 30 30 30 30 30 30 30 30 30 30 30 30 30 30 30 30 30 30 30 30 30 30 30 30 30 30 30 30 30 30
30 30 30 30 30 30 30 30 30 30 30 30 30 30 30 30 30 30 30 30 30 30 30 30 30 30 30 30 30 30 30 30 30 30 30 30 30 30 30 30 30 30 30 30 30 30 30 30 30 30
30 30 30 30 30 30 30 30 30 30 30 30 30 30 30 30 30 30 30 30 30 30 30 30 30 30 30 30 30 30 30 30 30 30 30 30 30 30 30 30 30 30 30 30 30 30 30 30 30 30